accountNumber,creditLimit,availableMoney,transactionDateTime,transactionAmount,merchantName,merchantCategoryCode,currentBalance
552158878,5000,5000,2016-01-02T05:35:07,0,Taco Bell #311677,fastfood,0
552158878,5000,5000,2016-01-03T00:53:56,36.45,AMC #191138,entertainment,0
552158878,5000,4963.55,2016-01-03T04:20:12,134.52,EZ Putt Putt #551896,entertainment,36.45
552158878,5000,4829.03,2016-01-03T11:34:22,180.52,AMC #692956,entertainment,170.97
552158878,5000,4648.51,2016-01-05T18:48:00,379.48,Regal Cinemas #05791,entertainment,351.49
552158878,5000,4269.03,2016-01-07T08:13:12,97.87,AMC #552863,entertainment,730.97
552158878,5000,4171.16,2016-01-09T05:25:36,264.81,Regal Cinemas #729464,entertainment,828.84
552158878,5000,3906.35,2016-01-09T10:44:25,106.34,EZ Putt Putt #240241,entertainment,1093.65
552158878,5000,3800.01,2016-01-10T16:45:41,245.62,EZ Putt Putt #240241,entertainment,1199.99
552158878,5000,3554.39,2016-01-10T17:38:22,424.48,EZ Putt Putt #503815,entertainment,1445.61
552158878,5000,3129.91,2016-01-11T01:02:10,80.21,AMC #606218,entertainment,1870.09
552158878,5000,3049.7,2016-01-12T10:50:27,241.39,EZ Putt Putt #755869,entertainment,1950.3
552158878,5000,2808.31,2016-01-13T07:01:17,151.4,AMC #692956,entertainment,2191.69
552158878,5000,2656.91,2016-01-13T08:32:18,209.28,Regal Cinemas #729464,entertainment,2343.09
552158878,5000,2447.63,2016-01-13T09:42:07,83.18,EZ Putt Putt #503815,entertainment,2552.37
552158878,5000,2364.45,2016-01-13T17:03:06,26,AMC #724446,entertainment,2635.55
552158878,5000,2338.45,2016-01-14T01:58:57,72.51,Regal Cinemas #05791,entertainment,2661.55
552158878,5000,2265.94,2016-01-15T01:54:33,140.47,EZ Putt Putt #503815,entertainment,2734.06
552158878,5000,2125.47,2016-01-15T08:50:58,97.88,AMC #74121,entertainment,2874.53
552158878,5000,2027.59,2016-01-17T21:36:57,9.17,EZ Putt Putt #503815,entertainment,2972.41
552158878,5000,2018.42,2016-01-18T07:05:06,1.88,AMC #145832,entertainment,2981.58
552158878,5000,2016.54,2016-01-18T08:24:45,339.56,Domino's Pizza #490157,fastfood,2983.46
552158878,5000,1676.98,2016-01-18T14:46:46,41.41,EZ Putt Putt #503815,entertainment,3323.02
552158878,5000,1635.57,2016-01-18T22:53:59,95.65,AMC #552863,entertainment,3364.43
552158878,5000,1539.92,2016-01-19T01:42:22,9.7,AMC #191138,entertainment,3460.08
552158878,5000,1530.22,2016-01-19T07:12:53,10.06,AMC #692956,entertainment,3469.78
552158878,5000,1520.16,2016-01-19T18:35:34,106.15,Regal Cinemas #276341,entertainment,3479.84
552158878,5000,1414.01,2016-01-20T20:33:49,567.94,AMC #606218,entertainment,3585.99
552158878,5000,846.07,2016-01-21T05:59:51,183.66,AMC #79863,entertainment,4153.93
552158878,5000,662.41,2016-01-23T05:15:51,79.49,Popeyes #295098,fastfood,4337.59
552158878,5000,582.92,2016-01-23T07:57:41,0,EZ Putt Putt #982199,entertainment,4417.08
552158878,5000,582.92,2016-01-23T10:09:04,27.89,AMC #706324,entertainment,4417.08
552158878,5000,555.03,2016-01-23T14:34:52,336.51,AMC #706324,entertainment,4444.97
552158878,5000,2116.35,2016-01-26T11:23:37,20.3,AMC #552863,entertainment,2883.65
552158878,5000,2096.05,2016-01-26T15:38:55,0,EZ Putt Putt #503815,entertainment,2903.95
552158878,5000,2096.05,2016-01-27T01:34:56,78.72,AMC #191138,entertainment,2903.95
552158878,5000,2017.33,2016-01-27T16:02:20,81.45,Burger King #58323,fastfood,2982.67
552158878,5000,1935.88,2016-01-27T20:09:22,27.73,AMC #706324,entertainment,3064.12
552158878,5000,1908.15,2016-01-27T20:24:22,268.17,Dunkin' Donuts #921434,fastfood,3091.85
552158878,5000,1639.98,2016-01-27T22:20:52,345.47,Five Guys #60282,fastfood,3360.02
552158878,5000,1294.51,2016-01-28T22:50:46,328.49,AMC #552863,entertainment,3705.49
552158878,5000,966.02,2016-01-29T07:34:02,4.61,AMC #606218,entertainment,4033.98
552158878,5000,961.41,2016-01-29T14:20:37,284.5,EZ Putt Putt #503815,entertainment,4038.59
552158878,5000,676.91,2016-01-30T01:43:54,15.9,AMC #79863,entertainment,4323.09
552158878,5000,661.01,2016-01-30T12:11:30,11.19,AMC #706324,entertainment,4338.99
552158878,5000,649.82,2016-01-30T19:21:36,183.26,Regal Cinemas #276341,entertainment,4350.18
552158878,5000,466.56,2016-01-31T09:59:44,26.18,EZ Putt Putt #69446,entertainment,4533.44
552158878,5000,440.38,2016-01-31T22:38:47,463.18,EZ Putt Putt #755869,entertainment,4559.62
552158878,5000,1968.1,2016-02-01T02:42:50,232.79,AMC #606218,entertainment,3031.9
552158878,5000,1735.31,2016-02-01T16:57:30,139.4,AMC #145832,entertainment,3264.69
552158878,5000,1595.91,2016-02-03T00:23:06,0.02,AMC #692956,entertainment,3404.09
552158878,5000,1595.89,2016-02-03T01:31:29,30.1,AMC #79863,entertainment,3404.11
552158878,5000,1565.79,2016-02-03T07:02:21,0.88,AMC #191138,entertainment,3434.21
552158878,5000,1564.91,2016-02-03T22:59:33,155.49,EZ Putt Putt #240241,entertainment,3435.09
552158878,5000,1409.42,2016-02-03T23:23:17,176.23,EZ Putt Putt #551896,entertainment,3590.58
552158878,5000,1233.19,2016-02-03T23:23:21,176.23,EZ Putt Putt #551896,entertainment,3766.81
552158878,5000,1056.96,2016-02-05T02:50:23,135.84,AMC #79863,entertainment,3943.04
552158878,5000,921.12,2016-02-05T12:08:29,256.05,AMC #79863,entertainment,4078.88
552158878,5000,665.07,2016-02-06T13:48:16,38.39,AMC #145832,entertainment,4334.93
552158878,5000,626.68,2016-02-06T15:56:20,0,AMC #724446,entertainment,4373.32
552158878,5000,626.68,2016-02-07T17:43:49,20.55,AMC #145832,entertainment,4373.32
552158878,5000,606.13,2016-02-07T18:22:24,34.01,AMC #724446,entertainment,4393.87
552158878,5000,572.12,2016-02-08T14:22:13,0,EZ Putt Putt #551896,entertainment,4427.88
552158878,5000,572.12,2016-02-09T06:19:18,103.75,Subway #339213,fastfood,4427.88
552158878,5000,468.37,2016-02-10T11:49:00,40.6,Regal Cinemas #729464,entertainment,4531.63
552158878,5000,427.77,2016-02-11T03:31:02,413.45,EZ Putt Putt #503815,entertainment,4572.23
552158878,5000,2808.19,2016-02-11T10:41:39,107.8,AMC #191138,entertainment,2191.81
552158878,5000,2700.39,2016-02-12T02:45:49,28.9,EZ Putt Putt #40513,entertainment,2299.61
552158878,5000,2671.49,2016-02-12T08:19:35,266.75,AMC #74121,entertainment,2328.51
552158878,5000,2404.74,2016-02-13T02:51:57,1.26,Regal Cinemas #05791,entertainment,2595.26
552158878,5000,2403.48,2016-02-13T10:12:19,31.37,EZ Putt Putt #40513,entertainment,2596.52
552158878,5000,2372.11,2016-02-13T16:26:16,0,AMC #191138,entertainment,2627.89
552158878,5000,2372.11,2016-02-14T12:17:38,35.21,Regal Cinemas #729464,entertainment,2627.89
552158878,5000,2336.9,2016-02-14T21:12:18,312.65,AMC #145832,entertainment,2663.1
552158878,5000,2024.25,2016-02-15T19:44:23,162.61,EZ Putt Putt #982199,entertainment,2975.75
552158878,5000,1861.64,2016-02-17T12:37:46,153.69,AMC #552863,entertainment,3138.36
552158878,5000,1707.95,2016-02-17T13:22:13,374.59,Regal Cinemas #729464,entertainment,3292.05
552158878,5000,1333.36,2016-02-18T08:34:31,0.73,AMC #128743,entertainment,3666.64
552158878,5000,1332.63,2016-02-18T11:26:07,37.78,EZ Putt Putt #551896,entertainment,3667.37
552158878,5000,1294.85,2016-02-19T00:41:23,49.45,AMC #128743,entertainment,3705.15
552158878,5000,1245.4,2016-02-19T02:27:32,66.97,EZ Putt Putt #69446,entertainment,3754.6
552158878,5000,1178.43,2016-02-19T14:36:22,469.04,AMC #74121,entertainment,3821.57
552158878,5000,709.39,2016-02-20T03:59:04,382.79,Domino's Pizza #530652,fastfood,4290.61
552158878,5000,326.6,2016-02-20T07:02:55,254.26,Regal Cinemas #05791,entertainment,4673.4
552158878,5000,4673.34,2016-02-21T08:56:55,25.3,Regal Cinemas #05791,entertainment,326.66
552158878,5000,4648.04,2016-02-21T23:49:26,102.32,EZ Putt Putt #982199,entertainment,351.96
552158878,5000,4545.72,2016-02-23T09:27:28,11.13,AMC #74121,entertainment,454.28
552158878,5000,4534.59,2016-02-23T20:50:36,202.56,AMC #724446,entertainment,465.41
552158878,5000,4332.03,2016-02-23T20:53:32,202.56,AMC #724446,entertainment,667.97
552158878,5000,4129.47,2016-02-24T13:14:16,320.58,AMC #606218,entertainment,870.53
552158878,5000,3808.89,2016-02-25T22:53:38,175.15,AMC #706324,entertainment,1191.11
552158878,5000,3633.74,2016-02-26T16:11:37,112.9,EZ Putt Putt #503815,entertainment,1366.26
552158878,5000,3520.84,2016-02-27T04:31:11,18.7,AMC #79863,entertainment,1479.16
552158878,5000,3502.14,2016-02-27T12:07:36,13.31,AMC #706324,entertainment,1497.86
552158878,5000,3488.83,2016-02-27T19:14:09,88.31,AMC #692956,entertainment,1511.17
552158878,5000,3400.52,2016-02-28T01:37:54,106.68,AMC #74121,entertainment,1599.48
552158878,5000,3293.84,2016-02-28T17:05:28,106.44,AMC #74121,entertainment,1706.16
552158878,5000,3187.4,2016-02-29T01:43:43,35.89,AMC #692956,entertainment,1812.6
552158878,5000,3151.51,2016-02-29T16:58:50,42.71,AMC #706324,entertainment,1848.49
552158878,5000,3108.8,2016-02-29T20:07:21,263.12,AMC #145832,entertainment,1891.2
552158878,5000,2870.68,2016-03-01T04:25:26,22.29,EZ Putt Putt #503815,entertainment,2129.32
552158878,5000,2848.39,2016-03-01T17:09:16,52.05,EZ Putt Putt #755869,entertainment,2151.61
552158878,5000,2796.34,2016-03-01T17:25:55,259.77,Pizza Hut #829289,fastfood,2203.66
552158878,5000,2536.57,2016-03-02T02:26:34,89.19,EZ Putt Putt #40513,entertainment,2463.43
552158878,5000,2447.38,2016-03-02T07:49:49,216.92,Regal Cinemas #729464,entertainment,2552.62
552158878,5000,2230.46,2016-03-02T09:24:20,26.29,EZ Putt Putt #982199,entertainment,2769.54
552158878,5000,2204.17,2016-03-02T17:03:16,121.94,Regal Cinemas #729464,entertainment,2795.83
552158878,5000,2082.23,2016-03-04T01:53:34,42.48,EZ Putt Putt #503815,entertainment,2917.77
552158878,5000,2039.75,2016-03-04T21:35:06,31.24,EZ Putt Putt #755869,entertainment,2960.25
552158878,5000,2008.51,2016-03-04T23:26:22,117.85,AMC #552863,entertainment,2991.49
552158878,5000,1890.66,2016-03-05T11:18:44,20.33,AMC #145832,entertainment,3109.34
552158878,5000,1870.33,2016-03-05T21:55:49,224.55,AMC #724446,entertainment,3129.67
552158878,5000,1645.78,2016-03-06T06:10:39,133.09,EZ Putt Putt #755869,entertainment,3354.22
552158878,5000,1512.69,2016-03-06T13:25:21,182.56,EZ Putt Putt #69446,entertainment,3487.31
552158878,5000,1330.13,2016-03-06T22:05:41,1322.64,AMC #552863,entertainment,3669.87
552158878,5000,556,2016-03-07T08:18:27,65.79,Regal Cinemas #05791,entertainment,4444
552158878,5000,490.21,2016-03-07T20:15:10,5.83,Regal Cinemas #276341,entertainment,4509.79
552158878,5000,484.38,2016-03-09T12:23:08,56.2,AMC #692956,entertainment,4515.62
552158878,5000,428.18,2016-03-09T13:14:25,40.99,AMC #552863,entertainment,4571.82
552158878,5000,387.19,2016-03-09T13:55:47,231.72,EZ Putt Putt #551896,entertainment,4612.81
552158878,5000,2324.69,2016-03-10T05:08:16,55.87,AMC #145832,entertainment,2675.31
552158878,5000,2268.82,2016-03-10T09:14:08,162.89,AMC #74121,entertainment,2731.18
552158878,5000,2105.93,2016-03-10T13:09:11,219.85,AMC #724446,entertainment,2894.07
552158878,5000,1886.08,2016-03-10T15:07:25,50.1,Regal Cinemas #729464,entertainment,3113.92
552158878,5000,1835.98,2016-03-10T18:15:18,408.78,EZ Putt Putt #804489,entertainment,3164.02
552158878,5000,1427.2,2016-03-10T23:59:29,115.98,AMC #552863,entertainment,3572.8
552158878,5000,1311.22,2016-03-11T16:54:46,13.92,In-N-Out #948343,fastfood,3688.78
552158878,5000,1297.3,2016-03-12T09:42:11,66.58,EZ Putt Putt #69446,entertainment,3702.7
552158878,5000,1230.72,2016-03-12T13:04:44,404.46,EZ Putt Putt #755869,entertainment,3769.28
552158878,5000,826.26,2016-03-13T01:33:32,160.24,AMC #606218,entertainment,4173.74
552158878,5000,666.02,2016-03-13T15:55:27,56.41,AMC #74121,entertainment,4333.98
552158878,5000,609.61,2016-03-13T20:22:36,32.12,AMC #74121,entertainment,4390.39
552158878,5000,577.49,2016-03-14T07:45:51,374.12,AMC #606218,entertainment,4422.51
552158878,5000,1591.85,2016-03-15T09:51:06,37.14,Regal Cinemas #729464,entertainment,3408.15
552158878,5000,1554.71,2016-03-16T06:49:27,88.77,AMC #128743,entertainment,3445.29
552158878,5000,1465.94,2016-03-16T23:44:26,75.5,Regal Cinemas #05791,entertainment,3534.06
552158878,5000,1390.44,2016-03-17T15:42:07,49.51,Regal Cinemas #729464,entertainment,3609.56
552158878,5000,1340.93,2016-03-18T09:40:25,221.58,Regal Cinemas #276341,entertainment,3659.07
552158878,5000,1119.35,2016-03-19T14:41:07,228.27,AMC #79863,entertainment,3880.65
552158878,5000,891.08,2016-03-20T03:10:28,209.74,Regal Cinemas #276341,entertainment,4108.92
552158878,5000,681.34,2016-03-21T15:43:01,169.91,EZ Putt Putt #40513,entertainment,4318.66
552158878,5000,511.43,2016-03-21T17:53:06,153.15,Regal Cinemas #276341,entertainment,4488.57
552158878,5000,358.28,2016-03-22T19:02:44,39.77,EZ Putt Putt #503815,entertainment,4641.72
552158878,5000,318.51,2016-03-22T21:04:32,176.52,AMC #692956,entertainment,4681.49
552158878,5000,1900.69,2016-03-22T21:23:10,19.62,AMC #145832,entertainment,3099.31
552158878,5000,1881.07,2016-03-24T01:01:54,72.77,AMC #145832,entertainment,3118.93
552158878,5000,1808.3,2016-03-24T02:20:39,302.49,Dunkin' Donuts #515185,fastfood,3191.7
552158878,5000,1505.81,2016-03-24T04:25:56,5.98,EZ Putt Putt #982199,entertainment,3494.19
552158878,5000,1499.83,2016-03-24T22:32:15,0,EZ Putt Putt #755869,entertainment,3500.17
552158878,5000,1499.83,2016-03-25T03:26:22,177.43,AMC #724446,entertainment,3500.17
552158878,5000,1322.4,2016-03-25T17:14:35,103.64,EZ Putt Putt #40513,entertainment,3677.6
552158878,5000,1218.76,2016-03-26T06:08:28,40.99,AMC #552863,entertainment,3781.24
552158878,5000,1259.75,2016-03-26T11:39:50,43.83,AMC #552863,entertainment,3740.25
552158878,5000,1215.92,2016-03-26T22:23:01,161.59,EZ Putt Putt #503815,entertainment,3784.08
552158878,5000,1054.33,2016-03-27T16:02:48,184.47,AMC #606218,entertainment,3945.67
552158878,5000,869.86,2016-03-30T16:05:04,60.44,AMC #145832,entertainment,4130.14
552158878,5000,809.42,2016-03-30T17:00:18,134.55,EZ Putt Putt #755869,entertainment,4190.58
552158878,5000,674.87,2016-03-30T19:48:50,462.71,AMC #606218,entertainment,4325.13
552158878,5000,5000,2016-03-31T04:40:12,80.5,AMC #145832,entertainment,0
552158878,5000,4919.5,2016-03-31T19:59:19,110.34,EZ Putt Putt #503815,entertainment,80.5
552158878,5000,4834.16,2016-04-01T05:50:48,470.99,AMC #191138,entertainment,165.84
552158878,5000,4363.17,2016-04-01T05:52:25,366.71,AMC #191138,entertainment,636.83
552158878,5000,4729.88,2016-04-02T02:36:19,13.53,EZ Putt Putt #40513,entertainment,270.12
552158878,5000,4716.35,2016-04-02T11:05:15,178.2,EZ Putt Putt #69446,entertainment,283.65
552158878,5000,4538.15,2016-04-02T18:16:27,520.45,Regal Cinemas #05791,entertainment,461.85
552158878,5000,4017.7,2016-04-02T20:30:21,427.25,EZ Putt Putt #755869,entertainment,982.3
552158878,5000,3590.45,2016-04-03T15:50:16,57.98,AMC #191138,entertainment,1409.55
552158878,5000,3532.47,2016-04-04T03:46:50,53.55,Regal Cinemas #05791,entertainment,1467.53
552158878,5000,3478.92,2016-04-04T11:33:22,55.05,EZ Putt Putt #503815,entertainment,1521.08
552158878,5000,3423.87,2016-04-05T09:32:47,17.83,AMC #606218,entertainment,1576.13
552158878,5000,3406.04,2016-04-06T00:52:21,64.11,AMC #79863,entertainment,1593.96
552158878,5000,3341.93,2016-04-06T08:03:52,178.51,AMC #128743,entertainment,1658.07
552158878,5000,3163.42,2016-04-07T16:45:54,150,AMC #692956,entertainment,1836.58
552158878,5000,3013.42,2016-04-07T17:29:49,115.28,AMC #724446,entertainment,1986.58
552158878,5000,2898.14,2016-04-08T00:06:20,167.96,KFC #304124,fastfood,2101.86
552158878,5000,2730.18,2016-04-08T00:24:09,427.59,AMC #74121,entertainment,2269.82
552158878,5000,2302.59,2016-04-08T19:36:34,94.56,AMC #79863,entertainment,2697.41
552158878,5000,2208.03,2016-04-09T05:00:37,153.66,AMC #191138,entertainment,2791.97
552158878,5000,2054.37,2016-04-09T12:31:06,10.42,EZ Putt Putt #982199,entertainment,2945.63
552158878,5000,2043.95,2016-04-10T06:11:20,34.66,AMC #706324,entertainment,2956.05
552158878,5000,2009.29,2016-04-11T07:42:12,57.92,AMC #724446,entertainment,2990.71
552158878,5000,1951.37,2016-04-12T02:11:33,9.22,AMC #606218,entertainment,3048.63
552158878,5000,1942.15,2016-04-12T11:56:22,149.91,Regal Cinemas #729464,entertainment,3057.85
552158878,5000,1792.24,2016-04-12T14:55:58,417.37,AMC #191138,entertainment,3207.76
552158878,5000,1374.87,2016-04-12T22:00:12,65.22,Domino's Pizza #822153,fastfood,3625.13
552158878,5000,1309.65,2016-04-15T03:52:50,156.06,AMC #191138,entertainment,3690.35
552158878,5000,1153.59,2016-04-15T17:28:34,20.75,AMC #552863,entertainment,3846.41
552158878,5000,1132.84,2016-04-15T18:15:58,88.78,EZ Putt Putt #240241,entertainment,3867.16
552158878,5000,1044.06,2016-04-16T04:53:53,71.34,EZ Putt Putt #40513,entertainment,3955.94
552158878,5000,972.72,2016-04-16T08:31:19,315.53,EZ Putt Putt #69446,entertainment,4027.28
552158878,5000,657.19,2016-04-17T15:51:30,26.29,AMC #552863,entertainment,4342.81
552158878,5000,630.9,2016-04-19T07:49:18,746.16,EZ Putt Putt #551896,entertainment,4369.1
552158878,5000,1124.32,2016-04-20T08:51:30,0,AMC #724446,entertainment,3875.68
552158878,5000,1124.32,2016-04-20T08:53:26,0,AMC #724446,entertainment,3875.68
552158878,5000,1124.32,2016-04-21T02:41:22,17.65,EZ Putt Putt #240241,entertainment,3875.68
552158878,5000,1106.67,2016-04-21T19:02:27,32.19,Regal Cinemas #05791,entertainment,3893.33
552158878,5000,1074.48,2016-04-22T03:12:28,80.27,Regal Cinemas #276341,entertainment,3925.52
552158878,5000,994.21,2016-04-22T06:32:33,0,EZ Putt Putt #804489,entertainment,4005.79
552158878,5000,994.21,2016-04-22T22:55:37,113.26,EZ Putt Putt #551896,entertainment,4005.79
552158878,5000,880.95,2016-04-23T15:30:05,4.02,AMC #74121,entertainment,4119.05
552158878,5000,876.93,2016-04-24T09:26:23,9.86,AMC #692956,entertainment,4123.07
552158878,5000,867.07,2016-04-24T15:57:47,118.98,EZ Putt Putt #240241,entertainment,4132.93
552158878,5000,748.09,2016-04-24T16:57:14,0,AMC #74121,entertainment,4251.91
552158878,5000,748.09,2016-04-26T11:54:51,122.5,EZ Putt Putt #240241,entertainment,4251.91
552158878,5000,625.59,2016-04-26T12:40:02,286.92,AMC #692956,entertainment,4374.41
552158878,5000,338.67,2016-04-27T05:45:17,134.55,EZ Putt Putt #755869,entertainment,4661.33
552158878,5000,473.22,2016-04-27T12:13:15,298.35,EZ Putt Putt #755869,entertainment,4526.78
552158878,5000,3023.06,2016-04-28T02:09:41,94.99,AMC #692956,entertainment,1976.94
552158878,5000,2928.07,2016-04-28T15:05:14,432.83,In-N-Out #672062,fastfood,2071.93
552158878,5000,2495.24,2016-04-28T19:40:38,203.2,AMC #724446,entertainment,2504.76
552158878,5000,2292.04,2016-04-29T20:26:25,13.05,Regal Cinemas #729464,entertainment,2707.96
552158878,5000,2278.99,2016-04-30T18:45:15,47.89,Starbucks #234833,fastfood,2721.01
552158878,5000,2256.1,2016-05-01T03:13:28,6.61,Wendys #731740,fastfood,2743.9
552158878,5000,2249.49,2016-05-01T05:32:43,73.09,EZ Putt Putt #982199,entertainment,2750.51
552158878,5000,2176.4,2016-05-01T09:43:54,77.15,AMC #74121,entertainment,2823.6
552158878,5000,2099.25,2016-05-03T10:17:07,18.05,AMC #724446,entertainment,2900.75
552158878,5000,2081.2,2016-05-04T04:07:37,278.26,AMC #79863,entertainment,2918.8
552158878,5000,1802.94,2016-05-05T07:56:36,49.03,EZ Putt Putt #240241,entertainment,3197.06
552158878,5000,1753.91,2016-05-05T11:14:40,66.52,AMC #706324,entertainment,3246.09
552158878,5000,1687.39,2016-05-06T01:04:40,118.73,AMC #79863,entertainment,3312.61
552158878,5000,1568.66,2016-05-06T20:07:42,254.03,AMC #706324,entertainment,3431.34
552158878,5000,1314.63,2016-05-07T05:50:45,422.39,AMC #724446,entertainment,3685.37
552158878,5000,892.24,2016-05-07T17:09:18,158.19,AMC #706324,entertainment,4107.76
552158878,5000,734.05,2016-05-07T18:45:10,0,AMC #724446,entertainment,4265.95
552158878,5000,734.05,2016-05-08T13:23:50,156.2,AMC #191138,entertainment,4265.95
552158878,5000,577.85,2016-05-09T10:56:23,107.94,AMC #706324,entertainment,4422.15
552158878,5000,469.91,2016-05-09T12:22:24,85.76,Regal Cinemas #729464,entertainment,4530.09
552158878,5000,384.15,2016-05-09T15:59:35,167.79,Regal Cinemas #05791,entertainment,4615.85
552158878,5000,4882.7,2016-05-10T12:25:40,382.42,AMC #191138,entertainment,117.3
552158878,5000,4500.28,2016-05-11T17:37:51,122.34,EZ Putt Putt #804489,entertainment,499.72
552158878,5000,4377.94,2016-05-12T22:42:54,24.2,Regal Cinemas #05791,entertainment,622.06
552158878,5000,4353.74,2016-05-13T08:02:32,568.98,AMC #191138,entertainment,646.26
552158878,5000,3784.76,2016-05-14T21:06:37,127.14,AMC #145832,entertainment,1215.24
552158878,5000,3657.62,2016-05-14T23:00:21,4.2,EZ Putt Putt #755869,entertainment,1342.38
552158878,5000,3653.42,2016-05-15T07:34:24,134.61,AMC #191138,entertainment,1346.58
552158878,5000,3518.81,2016-05-16T07:21:34,36.68,AMC #128743,entertainment,1481.19
552158878,5000,3482.13,2016-05-17T18:00:03,104.93,EZ Putt Putt #804489,entertainment,1517.87
552158878,5000,3377.2,2016-05-18T00:10:02,0,EZ Putt Putt #804489,entertainment,1622.8
552158878,5000,3377.2,2016-05-18T15:29:13,22.21,EZ Putt Putt #804489,entertainment,1622.8
552158878,5000,3354.99,2016-05-20T19:05:43,198.7,AMC #74121,entertainment,1645.01
552158878,5000,3156.29,2016-05-21T01:35:05,238.43,AMC #79863,entertainment,1843.71
552158878,5000,2917.86,2016-05-21T02:45:41,0.93,AMC #128743,entertainment,2082.14
552158878,5000,2916.93,2016-05-21T03:42:33,10.8,AMC #191138,entertainment,2083.07
552158878,5000,2906.13,2016-05-22T01:27:30,162.81,AMC #145832,entertainment,2093.87
552158878,5000,2743.32,2016-05-22T09:58:57,287.39,EZ Putt Putt #804489,entertainment,2256.68
552158878,5000,2455.93,2016-05-23T04:30:23,280.75,AMC #606218,entertainment,2544.07
552158878,5000,2175.18,2016-05-23T06:32:00,279.19,AMC #724446,entertainment,2824.82
552158878,5000,1895.99,2016-05-25T23:58:07,78.72,AMC #79863,entertainment,3104.01
552158878,5000,1817.27,2016-05-26T17:01:31,18.6,EZ Putt Putt #40513,entertainment,3182.73
552158878,5000,1798.67,2016-05-26T22:31:48,84.62,AMC #692956,entertainment,3201.33
552158878,5000,1714.05,2016-05-27T15:49:19,9.24,AMC #606218,entertainment,3285.95
552158878,5000,1704.81,2016-05-28T00:11:50,100.47,EZ Putt Putt #804489,entertainment,3295.19
552158878,5000,1604.34,2016-05-29T07:36:50,87.11,EZ Putt Putt #551896,entertainment,3395.66
552158878,5000,1517.23,2016-05-29T15:00:17,29.1,EZ Putt Putt #69446,entertainment,3482.77
552158878,5000,1488.13,2016-05-29T18:50:14,166.84,Regal Cinemas #276341,entertainment,3511.87
552158878,5000,1321.29,2016-05-30T03:53:45,141.73,Regal Cinemas #276341,entertainment,3678.71
552158878,5000,1179.56,2016-05-30T05:31:46,51.39,EZ Putt Putt #40513,entertainment,3820.44
552158878,5000,1128.17,2016-05-31T05:36:48,172.24,AMC #145832,entertainment,3871.83
552158878,5000,955.93,2016-05-31T09:38:26,108.86,AMC #552863,entertainment,4044.07
552158878,5000,847.07,2016-05-31T22:30:32,66.52,AMC #706324,entertainment,4152.93
552158878,5000,938.59,2016-06-01T11:14:10,32.74,AMC #79863,entertainment,4061.41
552158878,5000,905.85,2016-06-01T23:46:24,238.38,AMC #724446,entertainment,4094.15
552158878,5000,667.47,2016-06-02T11:49:44,80.26,EZ Putt Putt #551896,entertainment,4332.53
552158878,5000,587.21,2016-06-02T13:04:17,14.08,AMC #692956,entertainment,4412.79
552158878,5000,573.13,2016-06-02T16:42:17,33.44,AMC #724446,entertainment,4426.87
552158878,5000,539.69,2016-06-02T16:43:46,33.44,AMC #724446,entertainment,4460.31
552158878,5000,506.25,2016-06-02T20:48:43,640.26,AMC #191138,entertainment,4493.75
552158878,5000,3549.7,2016-06-03T05:44:49,5.8,EZ Putt Putt #755869,entertainment,1450.3
552158878,5000,3543.9,2016-06-03T09:26:24,49.83,Hardee's #301911,fastfood,1456.1
552158878,5000,3494.07,2016-06-03T19:28:22,36.34,EZ Putt Putt #69446,entertainment,1505.93
552158878,5000,3457.73,2016-06-05T12:56:22,243.91,EZ Putt Putt #69446,entertainment,1542.27
552158878,5000,3213.82,2016-06-06T18:05:55,54.99,Regal Cinemas #276341,entertainment,1786.18
552158878,5000,3158.83,2016-06-07T16:44:25,69.6,Regal Cinemas #729464,entertainment,1841.17
552158878,5000,3089.23,2016-06-09T05:20:32,231.99,Regal Cinemas #729464,entertainment,1910.77
552158878,5000,2857.24,2016-06-09T19:10:04,121.6,EZ Putt Putt #982199,entertainment,2142.76
552158878,5000,2735.64,2016-06-09T23:05:14,49.47,EZ Putt Putt #551896,entertainment,2264.36
552158878,5000,2686.17,2016-06-11T18:47:26,160.71,AMC #191138,entertainment,2313.83
552158878,5000,2525.46,2016-06-11T21:13:30,59.68,Regal Cinemas #05791,entertainment,2474.54
552158878,5000,2465.78,2016-06-12T20:31:40,0,EZ Putt Putt #503815,entertainment,2534.22
552158878,5000,2465.78,2016-06-12T20:33:35,0,EZ Putt Putt #503815,entertainment,2534.22
552158878,5000,2465.78,2016-06-13T01:25:25,191.14,EZ Putt Putt #240241,entertainment,2534.22
552158878,5000,2274.64,2016-06-13T20:32:57,83.46,AMC #724446,entertainment,2725.36
552158878,5000,2191.18,2016-06-14T00:07:32,84.2,EZ Putt Putt #503815,entertainment,2808.82
552158878,5000,2106.98,2016-06-14T17:19:22,9.01,EZ Putt Putt #40513,entertainment,2893.02
552158878,5000,2097.97,2016-06-15T04:04:21,115.39,EZ Putt Putt #240241,entertainment,2902.03
552158878,5000,1982.58,2016-06-15T12:25:57,72.4,AMC #74121,entertainment,3017.42
552158878,5000,1910.18,2016-06-16T20:26:42,42.13,Regal Cinemas #05791,entertainment,3089.82
552158878,5000,1868.05,2016-06-16T20:27:53,42.13,Regal Cinemas #05791,entertainment,3131.95
552158878,5000,1825.92,2016-06-17T12:21:00,140.48,Regal Cinemas #276341,entertainment,3174.08
552158878,5000,1685.44,2016-06-18T06:39:47,5.09,EZ Putt Putt #982199,entertainment,3314.56
552158878,5000,1680.35,2016-06-18T06:41:33,5.09,EZ Putt Putt #982199,entertainment,3319.65
552158878,5000,1685.44,2016-06-18T10:44:17,502.35,AMC #191138,entertainment,3314.56
552158878,5000,1183.09,2016-06-18T17:55:44,462.4,AMC #692956,entertainment,3816.91
552158878,5000,720.69,2016-06-18T20:23:59,50.34,EZ Putt Putt #755869,entertainment,4279.31
552158878,5000,670.35,2016-06-19T03:11:29,24.58,EZ Putt Putt #982199,entertainment,4329.65
552158878,5000,645.77,2016-06-20T23:17:22,440.16,AMC #552863,entertainment,4354.23
552158878,5000,3182.42,2016-06-21T03:15:59,48.47,AMC #692956,entertainment,1817.58
552158878,5000,3133.95,2016-06-21T05:35:48,58.02,AMC #191138,entertainment,1866.05
552158878,5000,3075.93,2016-06-22T03:51:05,116.59,AMC #606218,entertainment,1924.07
552158878,5000,2959.34,2016-06-23T05:46:06,198.99,AMC #128743,entertainment,2040.66
552158878,5000,2760.35,2016-06-23T22:37:40,92.02,EZ Putt Putt #240241,entertainment,2239.65
552158878,5000,2668.33,2016-06-23T23:36:58,0,AMC #692956,entertainment,2331.67
552158878,5000,2668.33,2016-06-23T23:37:15,0,AMC #692956,entertainment,2331.67
552158878,5000,2668.33,2016-06-24T02:31:03,116.33,EZ Putt Putt #40513,entertainment,2331.67
552158878,5000,2552,2016-06-24T05:38:05,293.56,Regal Cinemas #276341,entertainment,2448
552158878,5000,2258.44,2016-06-25T08:10:45,208.39,AMC #692956,entertainment,2741.56
552158878,5000,2050.05,2016-06-26T00:48:31,358.65,AMC #606218,entertainment,2949.95
552158878,5000,1691.4,2016-06-26T03:00:56,55.68,AMC #74121,entertainment,3308.6
552158878,5000,1635.72,2016-06-26T05:01:15,15.41,Regal Cinemas #729464,entertainment,3364.28
552158878,5000,1620.31,2016-06-26T06:22:11,246.36,EZ Putt Putt #503815,entertainment,3379.69
552158878,5000,1373.95,2016-06-26T14:32:51,292.3,AMC #606218,entertainment,3626.05
552158878,5000,1081.65,2016-06-26T22:18:54,205.15,EZ Putt Putt #503815,entertainment,3918.35
552158878,5000,876.5,2016-06-27T02:16:32,326.58,AMC #552863,entertainment,4123.5
552158878,5000,549.92,2016-06-30T02:32:59,127.81,Regal Cinemas #05791,entertainment,4450.08
552158878,5000,447.11,2016-07-01T23:22:52,162.37,KFC #760509,fastfood,4552.89
552158878,5000,284.74,2016-07-02T08:54:52,217,AMC #552863,entertainment,4715.26
552158878,5000,3089.94,2016-07-02T13:34:15,68.36,AMC #552863,entertainment,1910.06
552158878,5000,3021.58,2016-07-02T17:32:29,46.25,Burger King #821700,fastfood,1978.42
552158878,5000,2975.33,2016-07-03T03:37:59,218.21,Regal Cinemas #276341,entertainment,2024.67
552158878,5000,2757.12,2016-07-03T18:33:33,10.2,EZ Putt Putt #551896,entertainment,2242.88
552158878,5000,2746.92,2016-07-03T18:58:24,113.42,Quizno's #357998,fastfood,2253.08
552158878,5000,2633.5,2016-07-03T21:59:02,72.27,EZ Putt Putt #240241,entertainment,2366.5
552158878,5000,2561.23,2016-07-04T00:49:54,43.32,EZ Putt Putt #503815,entertainment,2438.77
552158878,5000,2517.91,2016-07-04T09:21:33,151.07,EZ Putt Putt #503815,entertainment,2482.09
552158878,5000,2366.84,2016-07-04T23:03:44,201.03,Auntie Anne's #39331,fastfood,2633.16
552158878,5000,2165.81,2016-07-05T13:04:16,138.36,AMC #79863,entertainment,2834.19
552158878,5000,2027.45,2016-07-06T06:30:01,314.08,EZ Putt Putt #40513,entertainment,2972.55
552158878,5000,1713.37,2016-07-06T18:14:24,376.74,EZ Putt Putt #503815,entertainment,3286.63
552158878,5000,1336.63,2016-07-07T02:12:25,76.32,AMC #79863,entertainment,3663.37
552158878,5000,1260.31,2016-07-07T03:28:04,184.55,EZ Putt Putt #40513,entertainment,3739.69
552158878,5000,1075.76,2016-07-07T14:15:33,14.58,EZ Putt Putt #755869,entertainment,3924.24
552158878,5000,1061.18,2016-07-10T02:04:34,7.44,AMC #191138,entertainment,3938.82
552158878,5000,1053.74,2016-07-10T05:45:00,112.6,AMC #724446,entertainment,3946.26
552158878,5000,941.14,2016-07-11T12:43:48,105.13,Regal Cinemas #729464,entertainment,4058.86
552158878,5000,836.01,2016-07-12T00:32:40,21.72,AMC #74121,entertainment,4163.99
552158878,5000,814.29,2016-07-12T10:29:02,297.23,AMC #191138,entertainment,4185.71
552158878,5000,517.06,2016-07-12T22:57:30,189.04,KFC #935101,fastfood,4482.94
552158878,5000,328.02,2016-07-13T20:02:14,50.43,AMC #706324,entertainment,4671.98
552158878,5000,277.59,2016-07-14T00:09:01,50.57,AMC #191138,entertainment,4722.41
552158878,5000,869.62,2016-07-14T04:34:23,31.18,EZ Putt Putt #804489,entertainment,4130.38
552158878,5000,838.44,2016-07-14T06:03:33,86.09,AMC #145832,entertainment,4161.56
552158878,5000,752.35,2016-07-14T07:43:34,106.92,AMC #79863,entertainment,4247.65
552158878,5000,645.43,2016-07-14T08:32:17,45.92,EZ Putt Putt #503815,entertainment,4354.57
552158878,5000,599.51,2016-07-14T13:12:01,125.12,AMC #706324,entertainment,4400.49
552158878,5000,474.39,2016-07-14T22:15:32,117.63,EZ Putt Putt #551896,entertainment,4525.61
552158878,5000,356.76,2016-07-15T11:00:30,2.62,EZ Putt Putt #69446,entertainment,4643.24
552158878,5000,354.14,2016-07-16T21:47:42,98.78,AMC #74121,entertainment,4645.86
552158878,5000,255.36,2016-07-17T18:07:55,0,EZ Putt Putt #40513,entertainment,4744.64
552158878,5000,255.36,2016-07-18T15:02:32,89.46,AMC #191138,entertainment,4744.64
552158878,5000,2086.69,2016-07-20T10:01:00,474.4,Burger King #968126,fastfood,2913.31
552158878,5000,1612.29,2016-07-22T11:55:33,85.64,EZ Putt Putt #69446,entertainment,3387.71
552158878,5000,1526.65,2016-07-23T11:33:50,146.06,EZ Putt Putt #69446,entertainment,3473.35
552158878,5000,1380.59,2016-07-25T01:49:40,21.74,Regal Cinemas #05791,entertainment,3619.41
552158878,5000,1358.85,2016-07-25T10:26:23,378.31,Raymour Flanigan,furniture,3641.15
552158878,5000,980.54,2016-07-26T00:24:02,127.01,EZ Putt Putt #240241,entertainment,4019.46
552158878,5000,853.53,2016-07-26T08:27:12,286.03,AMC #552863,entertainment,4146.47
552158878,5000,567.5,2016-07-27T11:02:30,153.17,EZ Putt Putt #804489,entertainment,4432.5
552158878,5000,414.33,2016-07-27T18:14:01,26.42,EZ Putt Putt #804489,entertainment,4585.67
552158878,5000,387.91,2016-07-28T06:33:30,166.37,Subway #970858,fastfood,4612.09
552158878,5000,3541.44,2016-07-28T12:38:48,57.47,EZ Putt Putt #503815,entertainment,1458.56
552158878,5000,3483.97,2016-07-28T18:24:20,0,AMC #145832,entertainment,1516.03
552158878,5000,3483.97,2016-07-29T02:12:20,14.33,EZ Putt Putt #755869,entertainment,1516.03
552158878,5000,3469.64,2016-07-29T03:43:29,161.93,AMC #79863,entertainment,1530.36
552158878,5000,3307.71,2016-07-29T13:05:59,304.26,Regal Cinemas #729464,entertainment,1692.29
552158878,5000,3003.45,2016-07-29T16:20:59,18.74,EZ Putt Putt #69446,entertainment,1996.55
552158878,5000,2984.71,2016-07-30T01:27:04,429.98,AMC #552863,entertainment,2015.29
552158878,5000,2554.73,2016-07-30T06:30:46,49.11,AMC #552863,entertainment,2445.27
552158878,5000,2505.62,2016-07-30T12:17:56,170.02,AMC #145832,entertainment,2494.38
552158878,5000,2335.6,2016-07-30T20:35:00,72.59,AMC #74121,entertainment,2664.4
552158878,5000,2263.01,2016-07-31T00:11:17,357.59,AMC #79863,entertainment,2736.99
552158878,5000,1905.42,2016-07-31T05:47:10,4.08,EZ Putt Putt #804489,entertainment,3094.58
552158878,5000,1901.34,2016-07-31T16:48:36,10.84,AMC #191138,entertainment,3098.66
552158878,5000,1915.5,2016-08-01T15:41:22,60.12,EZ Putt Putt #503815,entertainment,3084.5
552158878,5000,1855.38,2016-08-02T05:18:14,485.65,Regal Cinemas #05791,entertainment,3144.62
552158878,5000,1369.73,2016-08-03T22:46:14,314.08,EZ Putt Putt #40513,entertainment,3630.27
552158878,5000,1683.81,2016-08-04T12:40:59,257.47,EZ Putt Putt #503815,entertainment,3316.19
552158878,5000,1426.34,2016-08-05T07:45:33,40.14,AMC #128743,entertainment,3573.66
552158878,5000,1386.2,2016-08-05T09:43:17,89.16,EZ Putt Putt #40513,entertainment,3613.8
552158878,5000,1297.04,2016-08-05T12:01:52,0,Regal Cinemas #276341,entertainment,3702.96
552158878,5000,1297.04,2016-08-06T00:06:18,185.78,EZ Putt Putt #982199,entertainment,3702.96
552158878,5000,1111.26,2016-08-06T01:00:26,1.25,EZ Putt Putt #551896,entertainment,3888.74
552158878,5000,1110.01,2016-08-07T11:33:27,48.91,AMC #552863,entertainment,3889.99
552158878,5000,1061.1,2016-08-07T21:25:48,66.52,EZ Putt Putt #69446,entertainment,3938.9
552158878,5000,994.58,2016-08-08T05:12:05,37.79,EZ Putt Putt #804489,entertainment,4005.42
552158878,5000,956.79,2016-08-08T16:00:06,60.04,EZ Putt Putt #503815,entertainment,4043.21
552158878,5000,896.75,2016-08-09T14:25:35,33.84,AMC #74121,entertainment,4103.25
552158878,5000,862.91,2016-08-10T03:04:48,78.6,Regal Cinemas #276341,entertainment,4137.09
552158878,5000,784.31,2016-08-10T23:29:36,61.36,AMC #74121,entertainment,4215.69
552158878,5000,722.95,2016-08-11T14:41:55,7.6,Regal Cinemas #729464,entertainment,4277.05
552158878,5000,715.35,2016-08-12T18:14:35,40.72,EZ Putt Putt #40513,entertainment,4284.65
552158878,5000,674.63,2016-08-13T12:29:11,143.76,EZ Putt Putt #40513,entertainment,4325.37
552158878,5000,530.87,2016-08-13T14:40:55,136.75,EZ Putt Putt #551896,entertainment,4469.13
552158878,5000,394.12,2016-08-13T23:59:22,331.98,Quizno's #949567,fastfood,4605.88
552158878,5000,1730.47,2016-08-14T21:33:42,653.37,EZ Putt Putt #240241,entertainment,3269.53
552158878,5000,1077.1,2016-08-14T21:34:22,653.37,EZ Putt Putt #240241,entertainment,3922.9
552158878,5000,1730.47,2016-08-15T02:35:37,189.91,AMC #74121,entertainment,3269.53
552158878,5000,1540.56,2016-08-16T15:35:23,142.1,AMC #145832,entertainment,3459.44
552158878,5000,1398.46,2016-08-17T00:20:48,180.94,AMC #552863,entertainment,3601.54
552158878,5000,1217.52,2016-08-17T02:26:05,118.68,EZ Putt Putt #982199,entertainment,3782.48
552158878,5000,1098.84,2016-08-17T17:19:55,3.67,AMC #606218,entertainment,3901.16
552158878,5000,1095.17,2016-08-17T18:58:36,34.22,EZ Putt Putt #982199,entertainment,3904.83
552158878,5000,1060.95,2016-08-18T17:36:13,58.67,EZ Putt Putt #982199,entertainment,3939.05
552158878,5000,1002.28,2016-08-18T17:54:52,173.26,AMC #79863,entertainment,3997.72
552158878,5000,829.02,2016-08-18T22:46:48,201.35,AMC #128743,entertainment,4170.98
552158878,5000,627.67,2016-08-19T02:56:41,0,AMC #724446,entertainment,4372.33
552158878,5000,627.67,2016-08-21T21:27:48,527.72,Tim Hortons #294554,fastfood,4372.33
552158878,5000,3927.93,2016-08-22T20:53:33,290.55,Lyft,rideshare,1072.07
552158878,5000,3637.38,2016-08-24T08:28:32,162.12,EZ Putt Putt #503815,entertainment,1362.62
552158878,5000,3475.26,2016-08-25T01:06:55,56.42,Wendys #39414,fastfood,1524.74
552158878,5000,3418.84,2016-08-26T12:36:45,136.79,AMC #79863,entertainment,1581.16
552158878,5000,3282.05,2016-08-26T18:35:25,93.39,AMC #74121,entertainment,1717.95
552158878,5000,3188.66,2016-08-27T01:41:39,230.22,Domino's Pizza #530652,fastfood,1811.34
552158878,5000,2958.44,2016-08-28T05:51:54,0.95,AMC #145832,entertainment,2041.56
552158878,5000,2957.49,2016-08-28T10:31:13,123.63,EZ Putt Putt #551896,entertainment,2042.51
552158878,5000,2833.86,2016-08-28T19:26:15,260.15,EZ Putt Putt #551896,entertainment,2166.14
552158878,5000,2573.71,2016-08-29T20:05:08,1.66,Cinnabon #72579,fastfood,2426.29
552158878,5000,2572.05,2016-08-30T17:12:38,225.04,Subway #360346,fastfood,2427.95
552158878,5000,2347.01,2016-08-31T00:44:20,73.88,AMC #145832,entertainment,2652.99
552158878,5000,2273.13,2016-08-31T11:13:38,92.74,AMC #128743,entertainment,2726.87
552158878,5000,2205.39,2016-09-01T19:25:54,60.07,EZ Putt Putt #40513,entertainment,2794.61
552158878,5000,2145.32,2016-09-03T11:59:42,5.84,AMC #79863,entertainment,2854.68
552158878,5000,2139.48,2016-09-03T12:00:33,5.84,AMC #79863,entertainment,2860.52
552158878,5000,2133.64,2016-09-04T03:31:28,0,AMC #706324,entertainment,2866.36
552158878,5000,2133.64,2016-09-05T23:04:28,143.76,EZ Putt Putt #40513,entertainment,2866.36
552158878,5000,2277.4,2016-09-07T13:22:22,67.71,EZ Putt Putt #69446,entertainment,2722.6
552158878,5000,2209.69,2016-09-07T22:41:41,121.75,AMC #191138,entertainment,2790.31
552158878,5000,2087.94,2016-09-08T07:59:24,79.43,AMC #145832,entertainment,2912.06
552158878,5000,2008.51,2016-09-09T00:34:52,116.51,AMC #79863,entertainment,2991.49
552158878,5000,1892,2016-09-10T10:19:58,136.75,EZ Putt Putt #551896,entertainment,3108
552158878,5000,2028.75,2016-09-10T19:11:17,378.67,Popeyes #797184,fastfood,2971.25
552158878,5000,1650.08,2016-09-11T21:18:36,52.64,Regal Cinemas #729464,entertainment,3349.92
552158878,5000,1597.44,2016-09-12T02:31:50,229.43,AMC #128743,entertainment,3402.56
552158878,5000,1368.01,2016-09-12T04:03:05,20.14,AMC #552863,entertainment,3631.99
552158878,5000,1347.87,2016-09-12T15:35:19,1.73,AMC #724446,entertainment,3652.13
552158878,5000,1346.14,2016-09-12T16:50:00,3.78,AMC #128743,entertainment,3653.86
552158878,5000,1342.36,2016-09-12T16:55:18,131.85,AMC #692956,entertainment,3657.64
552158878,5000,1210.51,2016-09-13T18:55:29,82.97,EZ Putt Putt #69446,entertainment,3789.49
552158878,5000,1127.54,2016-09-14T06:11:50,199.71,AMC #191138,entertainment,3872.46
552158878,5000,927.83,2016-09-15T08:33:17,36.18,AMC #606218,entertainment,4072.17
552158878,5000,891.65,2016-09-15T13:49:24,52.67,Regal Cinemas #276341,entertainment,4108.35
552158878,5000,838.98,2016-09-16T00:46:47,135.2,AMC #79863,entertainment,4161.02
552158878,5000,703.78,2016-09-16T13:26:43,129.66,AMC #79863,entertainment,4296.22
552158878,5000,574.12,2016-09-17T06:11:14,179.7,EZ Putt Putt #40513,entertainment,4425.88
552158878,5000,394.42,2016-09-17T08:00:50,34.62,Regal Cinemas #276341,entertainment,4605.58
552158878,5000,359.8,2016-09-18T04:10:43,199.46,AMC #724446,entertainment,4640.2
552158878,5000,955.49,2016-09-18T22:20:17,32.94,AMC #706324,entertainment,4044.51
552158878,5000,922.55,2016-09-18T23:03:04,163.72,EZ Putt Putt #982199,entertainment,4077.45
552158878,5000,758.83,2016-09-19T10:25:20,165.54,EZ Putt Putt #503815,entertainment,4241.17
552158878,5000,593.29,2016-09-19T15:47:10,51.68,EZ Putt Putt #982199,entertainment,4406.71
552158878,5000,541.61,2016-09-20T07:29:03,505.98,EZ Putt Putt #240241,entertainment,4458.39
552158878,5000,4431.62,2016-09-21T05:49:34,12.09,AMC #79863,entertainment,568.38
552158878,5000,4419.53,2016-09-21T21:15:46,84.86,AMC #74121,entertainment,580.47
552158878,5000,4334.67,2016-09-22T15:53:49,188.92,AMC #606218,entertainment,665.33
552158878,5000,4145.75,2016-09-24T07:42:17,169.79,AMC #706324,entertainment,854.25
552158878,5000,3975.96,2016-09-24T11:09:13,86.64,AMC #191138,entertainment,1024.04
552158878,5000,3889.32,2016-09-26T12:42:58,323.11,EZ Putt Putt #755869,entertainment,1110.68
552158878,5000,3566.21,2016-09-26T16:23:40,428.86,Wendys #101984,fastfood,1433.79
552158878,5000,3137.35,2016-09-27T09:57:19,156.78,EZ Putt Putt #40513,entertainment,1862.65
552158878,5000,2980.57,2016-09-28T16:00:29,114.87,EZ Putt Putt #982199,entertainment,2019.43
552158878,5000,2865.7,2016-09-28T22:47:41,108.95,EZ Putt Putt #69446,entertainment,2134.3
552158878,5000,2756.75,2016-09-29T14:24:28,114.28,AMC #552863,entertainment,2243.25
552158878,5000,2642.47,2016-09-30T05:54:46,87.45,AMC #145832,entertainment,2357.53
552158878,5000,2555.02,2016-09-30T06:19:03,35.43,AMC #724446,entertainment,2444.98
552158878,5000,2519.59,2016-09-30T09:29:41,77.61,Regal Cinemas #276341,entertainment,2480.41
552158878,5000,2466.98,2016-10-01T14:18:11,357.59,AMC #724446,entertainment,2533.02
552158878,5000,2109.39,2016-10-01T18:18:47,10.6,Dairy Queen #699843,fastfood,2890.61
552158878,5000,2098.79,2016-10-02T02:20:45,120.74,AMC #724446,entertainment,2901.21
552158878,5000,1978.05,2016-10-02T03:51:05,45.6,AMC #191138,entertainment,3021.95
552158878,5000,1932.45,2016-10-02T11:21:55,0,EZ Putt Putt #503815,entertainment,3067.55
552158878,5000,1932.45,2016-10-03T01:33:32,43.36,EZ Putt Putt #755869,entertainment,3067.55
552158878,5000,1889.09,2016-10-03T08:45:53,15.33,AMC #706324,entertainment,3110.91
552158878,5000,1873.76,2016-10-03T10:38:57,163.72,EZ Putt Putt #982199,entertainment,3126.24
552158878,5000,2037.48,2016-10-03T18:51:45,150.7,AMC #706324,entertainment,2962.52
552158878,5000,1886.78,2016-10-04T04:33:58,57.52,AMC #706324,entertainment,3113.22
552158878,5000,1829.26,2016-10-05T11:56:28,273.34,EZ Putt Putt #69446,entertainment,3170.74
552158878,5000,1555.92,2016-10-07T08:16:51,78.66,Regal Cinemas #05791,entertainment,3444.08
552158878,5000,1477.26,2016-10-07T15:28:25,22.33,EZ Putt Putt #804489,entertainment,3522.74
552158878,5000,1454.93,2016-10-07T18:51:45,304.29,AMC #79863,entertainment,3545.07
552158878,5000,1150.64,2016-10-08T10:21:37,26.5,Starbucks #596555,fastfood,3849.36
552158878,5000,1124.14,2016-10-08T19:31:33,129.13,EZ Putt Putt #551896,entertainment,3875.86
552158878,5000,995.01,2016-10-09T00:05:45,8.23,EZ Putt Putt #755869,entertainment,4004.99
552158878,5000,986.78,2016-10-09T04:35:58,0.49,Regal Cinemas #05791,entertainment,4013.22
552158878,5000,986.29,2016-10-10T01:45:35,114.03,EZ Putt Putt #755869,entertainment,4013.71
552158878,5000,872.26,2016-10-10T14:20:33,186.51,EZ Putt Putt #551896,entertainment,4127.74
552158878,5000,685.75,2016-10-10T16:39:22,103.57,Regal Cinemas #05791,entertainment,4314.25
552158878,5000,582.18,2016-10-10T19:59:05,182.8,EZ Putt Putt #40513,entertainment,4417.82
552158878,5000,399.38,2016-10-11T16:09:12,13.76,AMC #552863,entertainment,4600.62
552158878,5000,385.62,2016-10-12T12:25:58,90.37,EZ Putt Putt #40513,entertainment,4614.38
552158878,5000,295.25,2016-10-12T15:11:27,132.06,EZ Putt Putt #69446,entertainment,4704.75
552158878,5000,2878.04,2016-10-13T20:33:36,83.47,EZ Putt Putt #40513,entertainment,2121.96
552158878,5000,2794.57,2016-10-13T23:40:59,61.77,Regal Cinemas #276341,entertainment,2205.43
552158878,5000,2732.8,2016-10-14T16:37:33,180.51,Burger King #780004,fastfood,2267.2
552158878,5000,2552.29,2016-10-16T06:33:25,119.75,Regal Cinemas #05791,entertainment,2447.71
552158878,5000,2432.54,2016-10-16T13:58:53,439.1,EZ Putt Putt #69446,entertainment,2567.46
552158878,5000,1993.44,2016-10-16T15:45:25,37.8,Wendys #295621,fastfood,3006.56
552158878,5000,1955.64,2016-10-16T17:13:37,71.53,EZ Putt Putt #551896,entertainment,3044.36
552158878,5000,1884.11,2016-10-17T18:23:52,81.47,Hardee's #315854,fastfood,3115.89
552158878,5000,1802.64,2016-10-19T00:52:10,238.21,AMC #191138,entertainment,3197.36
552158878,5000,1564.43,2016-10-19T04:35:12,436.56,AMC #692956,entertainment,3435.57
552158878,5000,1127.87,2016-10-19T05:36:24,8.15,EZ Putt Putt #982199,entertainment,3872.13
552158878,5000,1119.72,2016-10-19T13:53:46,0,EZ Putt Putt #503815,entertainment,3880.28
552158878,5000,1119.72,2016-10-20T02:15:35,172.79,Burger King #301056,fastfood,3880.28
552158878,5000,946.93,2016-10-20T02:27:19,612.22,Popeyes #344053,fastfood,4053.07
552158878,5000,334.71,2016-10-21T00:49:21,301.85,AMC #191138,entertainment,4665.29
552158878,5000,3258.88,2016-10-21T04:47:40,584.91,EZ Putt Putt #503815,entertainment,1741.12
552158878,5000,2673.97,2016-10-21T04:49:26,584.91,EZ Putt Putt #503815,entertainment,2326.03
552158878,5000,3258.88,2016-10-22T06:51:07,186.73,EZ Putt Putt #982199,entertainment,1741.12
552158878,5000,3072.15,2016-10-22T17:21:38,53.34,AMC #692956,entertainment,1927.85
552158878,5000,3018.81,2016-10-23T10:44:12,1.05,EZ Putt Putt #40513,entertainment,1981.19
552158878,5000,3017.76,2016-10-24T08:15:19,93.42,AMC #79863,entertainment,1982.24
552158878,5000,2924.34,2016-10-24T17:33:42,108.65,Regal Cinemas #276341,entertainment,2075.66
552158878,5000,2815.69,2016-10-25T03:58:13,28.88,EZ Putt Putt #982199,entertainment,2184.31
552158878,5000,2786.81,2016-10-25T05:34:42,58.61,EZ Putt Putt #804489,entertainment,2213.19
552158878,5000,2728.2,2016-10-25T09:31:41,47.65,EZ Putt Putt #69446,entertainment,2271.8
552158878,5000,2680.55,2016-10-25T23:17:49,68.65,EZ Putt Putt #503815,entertainment,2319.45
552158878,5000,2611.9,2016-10-26T12:55:38,4.24,EZ Putt Putt #982199,entertainment,2388.1
552158878,5000,2607.66,2016-10-27T05:05:11,172.8,AMC #692956,entertainment,2392.34
552158878,5000,2434.86,2016-10-30T15:59:38,94.6,Arbys #364155,fastfood,2565.14
552158878,5000,2340.26,2016-10-31T04:35:13,117.04,AMC #552863,entertainment,2659.74
552158878,5000,2248.22,2016-11-01T03:09:21,93.08,AMC #128743,entertainment,2751.78
552158878,5000,2155.14,2016-11-01T10:26:26,17.35,Hardee's #409032,fastfood,2844.86
552158878,5000,2137.79,2016-11-01T16:05:30,87.41,EZ Putt Putt #69446,entertainment,2862.21
552158878,5000,2050.38,2016-11-02T15:08:19,1144.22,Regal Cinemas #276341,entertainment,2949.62
552158878,5000,906.16,2016-11-02T18:44:45,1.99,AMC #74121,entertainment,4093.84
552158878,5000,904.17,2016-11-03T00:09:55,15.92,Dunkin' Donuts #83377,fastfood,4095.83
552158878,5000,888.25,2016-11-03T01:51:10,143.44,EZ Putt Putt #69446,entertainment,4111.75
552158878,5000,744.81,2016-11-03T07:42:37,0,AMC #191138,entertainment,4255.19
552158878,5000,744.81,2016-11-03T08:56:43,60.49,EZ Putt Putt #755869,entertainment,4255.19
552158878,5000,684.32,2016-11-04T04:40:37,220.51,KFC #313640,fastfood,4315.68
552158878,5000,463.81,2016-11-06T00:39:15,238.21,AMC #191138,entertainment,4536.19
552158878,5000,702.02,2016-11-06T12:14:56,537.42,Popeyes #196562,fastfood,4297.98
552158878,5000,2205.25,2016-11-07T11:58:32,116.96,EZ Putt Putt #40513,entertainment,2794.75
552158878,5000,2088.29,2016-11-08T00:03:30,18.68,EZ Putt Putt #240241,entertainment,2911.71
552158878,5000,2069.61,2016-11-08T04:05:59,238.2,Regal Cinemas #276341,entertainment,2930.39
552158878,5000,1831.41,2016-11-08T04:21:21,8.79,Regal Cinemas #276341,entertainment,3168.59
552158878,5000,1822.62,2016-11-08T06:41:35,56.46,EZ Putt Putt #503815,entertainment,3177.38
552158878,5000,1766.16,2016-11-09T05:47:48,581.03,Regal Cinemas #729464,entertainment,3233.84
552158878,5000,1185.13,2016-11-10T01:45:59,24.87,EZ Putt Putt #755869,entertainment,3814.87
552158878,5000,1160.26,2016-11-10T17:44:21,43.61,Regal Cinemas #276341,entertainment,3839.74
552158878,5000,1116.65,2016-11-12T19:54:00,32.37,AMC #552863,entertainment,3883.35
552158878,5000,1084.28,2016-11-12T23:00:38,10.58,AMC #79863,entertainment,3915.72
552158878,5000,1073.7,2016-11-13T00:21:15,117.76,AMC #79863,entertainment,3926.3
552158878,5000,955.94,2016-11-14T03:55:33,25.35,EZ Putt Putt #755869,entertainment,4044.06
552158878,5000,930.59,2016-11-14T14:02:24,26.5,EZ Putt Putt #69446,entertainment,4069.41
552158878,5000,904.09,2016-11-14T19:59:04,186.73,EZ Putt Putt #982199,entertainment,4095.91
552158878,5000,1090.82,2016-11-15T02:32:36,26.52,Starbucks #133985,fastfood,3909.18
552158878,5000,1064.3,2016-11-15T08:37:55,181.18,AMC #552863,entertainment,3935.7
552158878,5000,883.12,2016-11-15T12:54:17,13.4,AMC #128743,entertainment,4116.88
552158878,5000,869.72,2016-11-15T17:59:36,39.22,AMC #552863,entertainment,4130.28
552158878,5000,830.5,2016-11-15T22:31:18,662.37,AMC #724446,entertainment,4169.5
552158878,5000,284.23,2016-11-15T23:25:20,65,Regal Cinemas #276341,entertainment,4715.77
552158878,5000,2253.81,2016-11-16T03:07:54,173.52,EZ Putt Putt #240241,entertainment,2746.19
552158878,5000,2080.29,2016-11-16T10:52:05,202.55,AMC #706324,entertainment,2919.71
552158878,5000,1877.74,2016-11-16T22:27:33,258.03,AMC #692956,entertainment,3122.26
552158878,5000,1619.71,2016-11-18T05:17:46,290.51,EZ Putt Putt #982199,entertainment,3380.29
552158878,5000,1329.2,2016-11-18T19:54:59,17.5,EZ Putt Putt #551896,entertainment,3670.8
552158878,5000,1311.7,2016-11-19T01:10:21,0,AMC #692956,entertainment,3688.3
552158878,5000,1311.7,2016-11-19T05:28:08,55.39,EZ Putt Putt #240241,entertainment,3688.3
552158878,5000,1256.31,2016-11-19T14:42:55,16.59,Dunkin' Donuts #458393,fastfood,3743.69
552158878,5000,1239.72,2016-11-20T07:02:03,6.67,EZ Putt Putt #240241,entertainment,3760.28
552158878,5000,1233.05,2016-11-20T13:53:30,234.52,Regal Cinemas #729464,entertainment,3766.95
552158878,5000,998.53,2016-11-21T19:27:17,137.99,AMC #724446,entertainment,4001.47
552158878,5000,860.54,2016-11-21T19:31:11,431.49,AMC #706324,entertainment,4139.46
552158878,5000,429.05,2016-11-22T07:46:28,91.09,Regal Cinemas #05791,entertainment,4570.95
552158878,5000,337.96,2016-11-23T03:21:22,20.71,EZ Putt Putt #551896,entertainment,4662.04
552158878,5000,317.25,2016-11-23T20:04:30,259.51,AMC #79863,entertainment,4682.75
552158878,5000,2616.84,2016-11-23T22:27:54,16.9,AMC #552863,entertainment,2383.16
552158878,5000,2599.94,2016-11-24T13:32:47,54.41,AMC #606218,entertainment,2400.06
552158878,5000,2545.53,2016-11-24T17:56:04,405.53,AMC #74121,entertainment,2454.47
552158878,5000,2140,2016-11-24T20:50:30,14.28,AMC #606218,entertainment,2860
552158878,5000,2125.72,2016-11-26T04:06:37,43.91,Lyft,rideshare,2874.28
552158878,5000,2081.81,2016-11-26T11:49:57,3.42,AMC #552863,entertainment,2918.19
552158878,5000,2078.39,2016-11-26T14:30:42,279.06,Regal Cinemas #05791,entertainment,2921.61
552158878,5000,1799.33,2016-11-27T04:45:24,6.29,AMC #606218,entertainment,3200.67
552158878,5000,1793.04,2016-11-27T13:06:34,31.24,Regal Cinemas #276341,entertainment,3206.96
552158878,5000,1761.8,2016-11-28T22:10:50,29.65,EZ Putt Putt #69446,entertainment,3238.2
552158878,5000,1732.15,2016-11-29T03:07:20,84.71,AMC #692956,entertainment,3267.85
552158878,5000,1647.44,2016-11-29T08:22:28,38.67,AMC #79863,entertainment,3352.56
552158878,5000,1608.77,2016-11-30T21:47:04,97.06,AMC #692956,entertainment,3391.23
552158878,5000,1536.71,2016-12-01T07:15:00,11.94,Regal Cinemas #729464,entertainment,3463.29
552158878,5000,1524.77,2016-12-01T17:48:42,108.16,AMC #724446,entertainment,3475.23
552158878,5000,1416.61,2016-12-01T19:48:20,263.03,EZ Putt Putt #240241,entertainment,3583.39
552158878,5000,1153.58,2016-12-02T17:18:00,135.25,EZ Putt Putt #755869,entertainment,3846.42
552158878,5000,1018.33,2016-12-02T18:25:58,237.5,AMC #74121,entertainment,3981.67
552158878,5000,780.83,2016-12-02T21:43:38,55.28,EZ Putt Putt #40513,entertainment,4219.17
552158878,5000,725.55,2016-12-03T00:29:44,1.84,AMC #552863,entertainment,4274.45
552158878,5000,723.71,2016-12-04T06:14:57,185.67,EZ Putt Putt #40513,entertainment,4276.29
552158878,5000,538.04,2016-12-04T17:20:53,40.37,EZ Putt Putt #755869,entertainment,4461.96
552158878,5000,497.67,2016-12-05T00:31:25,17.33,AMC #724446,entertainment,4502.33
552158878,5000,480.34,2016-12-06T21:10:10,165.45,EZ Putt Putt #40513,entertainment,4519.66
552158878,5000,314.89,2016-12-07T08:02:22,37.51,AMC #724446,entertainment,4685.11
552158878,5000,277.38,2016-12-10T16:58:35,209.13,AMC #724446,entertainment,4722.62
552158878,5000,2512.84,2016-12-10T18:47:55,21.63,EZ Putt Putt #240241,entertainment,2487.16
552158878,5000,2491.21,2016-12-12T03:02:17,52.14,AMC #606218,entertainment,2508.79
552158878,5000,2439.07,2016-12-12T17:29:08,303.32,Regal Cinemas #05791,entertainment,2560.93
552158878,5000,2135.75,2016-12-13T13:14:05,3.05,EZ Putt Putt #804489,entertainment,2864.25
552158878,5000,2132.7,2016-12-13T23:00:52,642.67,AMC #692956,entertainment,2867.3
552158878,5000,1490.03,2016-12-16T01:02:38,42.2,EZ Putt Putt #982199,entertainment,3509.97
552158878,5000,1447.83,2016-12-17T01:57:22,0,AMC #692956,entertainment,3552.17
552158878,5000,1447.83,2016-12-18T15:10:44,169.95,EZ Putt Putt #982199,entertainment,3552.17
552158878,5000,1277.88,2016-12-19T09:38:23,93.27,AMC #724446,entertainment,3722.12
552158878,5000,1184.61,2016-12-19T09:51:43,24.55,Krispy Kreme #653472,fastfood,3815.39
552158878,5000,1160.06,2016-12-19T22:02:47,12.14,EZ Putt Putt #40513,entertainment,3839.94
552158878,5000,1147.92,2016-12-20T19:33:52,10.24,AMC #79863,entertainment,3852.08
552158878,5000,1137.68,2016-12-21T13:59:53,58.51,AMC #724446,entertainment,3862.32
552158878,5000,1079.17,2016-12-21T20:29:23,157.65,AMC #79863,entertainment,3920.83
552158878,5000,921.52,2016-12-21T20:53:24,7.11,AMC #145832,entertainment,4078.48
552158878,5000,914.41,2016-12-22T00:51:34,148.77,Regal Cinemas #05791,entertainment,4085.59
552158878,5000,765.64,2016-12-22T06:37:35,627.51,EZ Putt Putt #755869,entertainment,4234.36
552158878,5000,3282.62,2016-12-22T10:12:10,35.42,EZ Putt Putt #982199,entertainment,1717.38
552158878,5000,3247.2,2016-12-22T15:30:51,31.14,Regal Cinemas #729464,entertainment,1752.8
552158878,5000,3216.06,2016-12-23T00:32:55,194.51,EZ Putt Putt #40513,entertainment,1783.94
552158878,5000,3021.55,2016-12-24T11:44:04,93.15,KFC #336186,fastfood,1978.45
552158878,5000,2928.4,2016-12-25T01:52:39,114.09,Regal Cinemas #729464,entertainment,2071.6
552158878,5000,2814.31,2016-12-25T04:51:52,314.24,AMC #191138,entertainment,2185.69
552158878,5000,2500.07,2016-12-25T10:41:48,115.41,AMC #79863,entertainment,2499.93
552158878,5000,2384.66,2016-12-25T15:42:11,57.77,AMC #145832,entertainment,2615.34
552158878,5000,2326.89,2016-12-26T00:44:20,175.19,AMC #606218,entertainment,2673.11
552158878,5000,2151.7,2016-12-26T02:18:23,125.59,AMC #692956,entertainment,2848.3
552158878,5000,2026.11,2016-12-27T07:11:57,527.27,Regal Cinemas #05791,entertainment,2973.89
552158878,5000,1498.84,2016-12-27T12:57:31,61.57,Hardee's #794138,fastfood,3501.16
552158878,5000,1437.27,2016-12-29T17:21:58,11.97,AMC #74121,entertainment,3562.73
552158878,5000,1425.3,2016-12-30T02:13:17,73.46,EZ Putt Putt #503815,entertainment,3574.7